// this file is fragile, do not use tabs, do not space out the picname=titlename=color setup, only the title name can have spaces, do not space out lines
// possible colors are "r" "g" "b"
SCRNAV=Alien Vandetta=g
SCRNDIB=Drown In Blood=r
SCRND2=Doom2=g
SCRN1994=1994 Tune Up Project=g
SCRNCOC=Circle of Caina=g
SCRNCS=Combat Shock=r
SCRNCS2=Combat Shock 2=r
SCRNDARKT=Dark Tartarus=r
SCRNDCT=Doom Core Trilogy=g
SCRNDKE=Dark Encounters=g
SCRNDV=Deus Vult=r
SCRNEST=Estranged=g
SCRNEYE=The Eye=b
SCRNFSW=Forest Swords=g
SCRNGD=Going Down=g
SCRNGOTH=New Gothic Movement 1=r
SCRNHADE=Hadephobia=g
SCRNHC=Hell Core=g
SCRNHELLB=Hellbound=g
SCRNHR=Hell Revealed=g
SCRNHR2=Hell Revealed 2=g
SCRNKSUT=Kamasutra=g
SCRNMAY=Mayhem 17=g
SCRNMOC=Maps of Chaos=g
SCRNMOM=Monuments Of Mars=g
SCRNPIZZA=Pizza Steve=r
SCRNSC2=Scythe 2=g
SCRNSHIT=Khorus's Speedy Shit=g
SCRNSL=Shai'tans Luck=r
SCRNSNDER=Sunder=r
SCRNSOD=Speed of Doom=g
SCRNSPIRE=The Spire=b
SCRNSUN=Sunlust=g
SCRNSWIFT=Swift Death=g
SCRNUAC=UAC Ultra=g
SCRNUR=Unholy Realms=g
SCRNVAN=Vanguard=g
SCRNWID=Doom 2 the way Id Did=g
SCRNWOS=Whispers of Satan=g